########################################
# ............. ## ................... #
# ##### ######     ######## ########## #
# #             ## ................... #
# #                ######## ########## #
# #     ######  ## ................... #
#       # B        ######## ########## #
# #     ######  ## ................... #
# #                ######## ########## #
# #             ## ................... #
# #                ######## ########## #
# #             ## ................... #
# #       C        ######## ########## #
# #             ## ................... #
#                  ######## ########## #
#       ######  ## ................... #
# #     # b        ######## ########## #
# #     ######  ## ................... #
# #                ######## ########## #
# #             ## ................... #
# ############     ######## ########## #
# ............. ## ................... #
########################################
